NO ./path_to_the_north_texture
SO ./path_to_the_south_texture
WE ./path_to_the_west_texture
EA ./path_to_the_east_texture


F 220,100,0
C 225,30,0

        s
        1
        1111111111111111111111111
        1000000000110000000000001
        1011000001110000000000001
        1001000000000000000000001
111111111011000001110000000000001
100000000011000001110111111111111
11110111111111011100000010001
11110111111111011101010010001
11000000110101011100000010001
10000000000000001100000010001
10000000000000001101010010001
21000222222201022211011110N0233
211102  3  20102 2011110100023
22222222 2222222 222222222222


111
  1
  1
  1
111

111
1 1
1 11
1111
 111

1111
1001
1P11
1111

1111111111
10000000P1
1000000001
1 11111001
111   1001
     11001
     11101
    111111

проверить на наличие невалидных символови и что игрок только один
идти с следующим приорететом
L F R FK_GO_BACK
заменяем пройденные стены на 2
тупик - идем назад, если нашли путь без 2, идем по нему, если оказались в начальной точке - ошибка
проверяем, что между последовательностями двоек только пробелы
